WWWWWWWWWWWWWWWWW
WWWWWWWWWWWWWWWWW
WWWWLW...V.....WW
WWWW.W.WW.WWWW.WW
WWWWSW....W.WV.WW
WWWW.W..R.R.WC.WW
WWWW.W....W.WS.WW
WWWW.W..W.W.W..WW
WWW..WWWW.W.W..WW
WW..VWH.....W..WW
WW..........W..WW
WW.WWWWWWWWWW.WWW
WW.........HWLWWW
WWWWWWW.WRWWWSWWW
WWP........X...WW
WWWWWWWWWWWWWWWWW
WWWWWWWWWWWWWWWWW
