WWWWWWWWWWWWWWWWW
WWWWWWWWWWWWWWWWW
WW....WCS...V..WW
WW.R..WTW.....WWW
WWW..WWL.......WW
WW....V..WWW.L.WW
WW.......W.W.L.WW
WW.W.....S..W..WW
WW.WWW....W..WWWW
WW...W....W....WW
WW...WW..WW....WW
WW....WWWWWWRWWWW
WWH....W.....WXWW
WW..WWWV...W.W.WW
WWP............WW
WWWWWWWWWWWWWWWWW
WWWWWWWWWWWWWWWWW