WWWWWWWWWWWWWWWWW
WWWWWWWWWWWWWWWWW
WWWWVWLS....H..WW
WWWW.WWWWWWWWWWWW
WWWWSW.H.....SLWW
WWWWLWWWWWWWWWWWW
WWWWSWWWWWWWWWVWW
WWWW.WWWWWWWWW.WW
WWWWWWWWWWWWWWSWW
WW.....SCWWWWWSWW
WW.RL..WWWWWWW.WW
WW.RL..WWWWWWWLWW
WW.RL..WWWWWWW.WW
WW.RL..WWWWWWWSWW
WWP....S...TXWLWW
WWWWWWWWWWWWWWWWW
WWWWWWWWWWWWWWWWW
