WWWWWWWWWWWWWWWWW
WWWWWWWWWWWWWWWWW
WW.....V...V...WW
WW.............WW
WW.............WW
WWW.WWW........WW
WWW..WWW.......WW
WW.....WWWWWW..WW
WW............WWW
WWWRWWWWWWWWW..WW
WW.......W.....WW
WW...H...WWW.H.WW
WW...WWWWW.....WW
WW.W.WC........WW
WWP............XW
WWWWWWWWWWWWWWWWW
WWWWWWWWWWWWWWWWW
