WWWWWWWWWWWWWWWWW
WWWWWWWWWWWWWWWWW
WW.....V...V...WW
WW.............WW
WW.............WW
WWW.WWW........WW
WWW..WWW.......WW
WW.....WWWWWW..WW
WW............WWW
WWWRWWWWWWWWW..WW
WW.......W.....WW
WW..YH...WWW.H.WW
WW...WWWWW.....WW
WW.WLWC........WW
WWP..W.........XW
WWWWWWWWWWWWWWWWW
WWWWWWWWWWWWWWWWW
