WWWWWWWWWWWWWWWWW
WWWWWWWWWWWWWWWWW
WWL.........H..WW
WW.............WW
WW.............WW
WW......L......WW
WW.............WW
WW......V......WW
WW.............WW
WWWWWWWWWWWW...WW
WW.RL....WCW...WW
WW..WWSW.WSW...WW
WW.....WTW.W...WW
WW.PWWWW.W.WWWWWW
WW..WWWW.S....XWW
WWWWWWWWWWWWWWWWW
WWWWWWWWWWWWWWWWW
