WWWWWWWWWWWWWWWWW
WWWWWWWWWWWWWWWWW
WW.............WW
WW.............WW
WW.............WW
WW.............WW
WW.............WW
WW.............WW
WW.............WW
WW.............WW
WW.............WW
WW.............WW
WW.............WW
WW.P...........WW
WW............XWW
WWWWWWWWWWWWWWWWW
WWWWWWWWWWWWWWWWW